+---+---+---+---+---+
| S     |           |
+   +   +   +---+   +
|   |       |       |
+   +---+---+   +   +
|           |   |   |
+---+   +---+   +   +
|       |       |   |
+   +---+   +---+   +
|       |       | F |
+---+---+---+---+---+

