+---+---+---+---+---+---+---+
| S     |           |       |
+   +   +---+   +   +---+   +
|   |           |   |       |
+   +---+---+---+   +   +   +
|           |   |   |   |   |
+---+---+---+   +   +   +---+
|       |           |       |
+   +   +   +---+---+---+   +
|   |       |               |
+   +---+---+---+---+   +---+
|       |           |       |
+---+   +   +---+   +---+   +
|           |             F |
+---+---+---+---+---+---+---+

