+---+---+---+---+---+
| S     |           |
+   +---+   +---+   +
|       |   |       |
+   +   +   +---+---+
|   |       |       |
+   +---+---+   +   +
|   |           |   |
+   +---+   +---+   +
|           |     F |
+---+---+---+---+---+
